*..BW.BB..B..B......
.....W...WW..B......
.....WB..BB..B.B.B.B
W..E....W..W.....BB.
BBB.......E.........
.W.W..B.W..WWB.B.EB.
W..B..W..B...BB.WB.B
...WBBW.....WB.BBWW.
...WW.....W......W..
..........W..B..BW..
..W....BBB..B.BB.WB.
..........B.HW...B.W
.........WW.BW.BWB..
....B...B...........
W...BWW..B.....B....
BW..W.BB.....B..BBB.
......B..WB.........
..W....BW.......BW.W
..W.B..B.BBW......WW
....B.B...B.....W...
