*..B.BBBB..B.W....B.
....W.W...WB.W......
.W..B.W.BWB..W....B.
..WE.WB..B.B...B....
B....BB.EW.BB.B...B.
..BW.B.B....WE.WBB..
.W.......W.BW.B.W.E.
....B.BB....B.B.....
...EWW.WB.B......BWW
..BW....E..W....B...
B....W...B.B........
B.W..W.BB.B...B.....
...B..W..W..B..W..W.
B.BBB.W....WH..BW...
BB.BWB.WW.....B.B.B.
....B.B.B...B..BW...
..W....B.....W...W..
.B.BBBB..WB.B.W.....
W..W...........B.W..
.....B..B.B.W...W..*
