*..W.......BW..WWW.B
......BBB..B...B..B.
......B.B.W.W...BB.B
.BWE.B..B........W..
W.W..B...BEB...BBB..
..W....WB....W..WE.B
....BW..WB...B.BWB..
.....W.............B
....WB..B...B...B...
.BBW.........W...B.B
...EW......W..BB....
BW......BB....HBBB..
.......B...B........
WB.....B..B.WBB.W...
...B.....B...W..W...
W..W.W....WBWW...B..
.WW.W..W.B........W.
...BWBW....W...B....
..BB..BB.B..W.BBB...
...WW.W.B...W..W....
