*....WBW..........W.
.....BWWWB..W.W..B..
..W...W..B.W.....B..
...E.BBBB........W..
B.....WBE....B.B..WB
B....B...BB..E...WBW
W..WWWB...BBB...B.E.
BB.B.W....W.......WB
..BE.W..B..BBB.B.B..
WW..B..B.....B.W...B
..B..B.......B......
.W...WW.B.BB..B.BB.W
..WW...B.W..........
..B..WBW.W.....W.BB.
.W.W........B..B.H..
W.W..B..B...B..WB.B.
..BBB...WB....B..B..
..B..B.BWB..B....W.B
..B....B.W.W........
BB..B.....W.....BW.*
