*..WW.B.BW.W.W.WB...
..W...B......W....B.
..B..B.WB...B.B.WW..
..WE.....W...B....W.
.W.B....E...W..WW...
...BB....B.B.E......
B.B.......B..WB..WEB
....WBW.B.BBBWB.BBBB
WBBE......W....B.B..
.B..BWBWEW..B...BB..
............WE.WW..B
B.B.WW..W.B.B...B..B
.B....B...W.B.....B.
W.......B.....B..H.B
......W..BBW.WBB.W.B
...........WWB..B...
B...B.....B...B..B..
.WBWB........W.W.B..
BB......BWB..B......
......BB.WBW....BW.*
