*.W..WB.........WB.*
...WBB....B..BB.BW..
BB....B.BBBB....B...
...EB...B...........
B....B.EB....B..B.WB
.BB......B.EB...B...
.....BW..B...B.E.W..
...E.........BW.W...
W....W.EB...WB..B..B
.W......BW.E..BB....
.WBW..BW.W...W.EBB.W
B.BEB....B.H.....B..
B.W...BEB........WW.
B.WB..B....E.B...W..
....WB.B...W...E....
...EBB.B...B....BW.W
......WE....BW.B.W.B
BB.B.WBWB.......B.W.
.........W..WBW..B..
*...BW.B.B.B...B.B.*
