*...B.........B.WWBB
...B.B........W.W..B
....WW.....B.B...B..
BB.E.BB.....B..B.W..
....WB.BE..W....W.BB
B.....B.WW...EW.BBBB
.B......BB...WBB..EB
...W.BB.WW.BB...B.BB
B..EW..BWB..W.W...B.
...W.B..EW.....W.B..
.B.....WB.B.B.W....B
..B.B.WWB.B...WBBW..
..B...B.............
...B....W.....W.....
..B.B.WW.BBW.B..W...
.B..WWB......W..B...
W.W..W............W.
..B.......B.W...W.H.
....W.....BWWB......
.W.B..BB.WB..BBBBB.*
