*........B..BB..BW.B
..W..B.W.WB..B.W....
.B.W...W.WB......B..
...E..BB..B....B..B.
..B..W..EW.B..WB.B..
....W......W.E....W.
.B......BB....WB..EB
...WBBB.B...B...B.BW
...E...WBBWWWB.....B
.B.....BE..WWW......
BB.......BW.W.B...BB
B.....B.WB..........
W...W..W....B...W..B
.BB..W..B.B....B..W.
..BB.B.WBWW...W.B.WB
B.B......W....W.B...
...BB.W.W.......W.W.
.B..B.W...HWBW.B.B..
.B.BB...BB.....B.W..
..B.B..B.....BW..W.*
