*.W.BB...B....BW.W.*
.......W.....B...W..
.W.BB....BW..BBWWB..
...E.W........B.B...
W.B...BE....WW.W....
...B.B.WB.BE........
..BB.W.W.B.W..BE.B..
B..E.BB..B..B..BBB.B
...B.WWEBWB.BBW..BW.
.WB.BW.....E.WW....B
.....WW...W....E.B.W
.B.E...WB....B.W...B
..B..B.E.BBBB..B.B.B
B.B.....B..EBB.B.WH.
.........B...W.EWB..
.B.E..........B...B.
.......EW.....B...B.
B.B..B...B........B.
.......B.W.B..B.....
*..B..B.W..B..W....*
