*.......WB..B...W..*
..B..BB.BB.....B.W..
.B...B.....BB.BBB...
..WE.B..B...BB...B.B
...B..EB.WBBB....BBB
BBW.B...WEB..B...WBB
BB.EB...B.W...BWB...
...B..EB....W..B....
BW.BW...BE..B.W..B..
BBWE.W..WW.WB.....W.
.W....E.B..W..B....W
..BB.....EW.BH.B....
B.WE.......BW.B..BWW
..B..WE.B..B....B..W
W..BW.B.BE.WB....B..
.B.E....W.BB........
...W..E.....B.WBBWB.
BBB...B.WE....W.BBB.
...E....B...W....B..
*..B..........B....*
