*...B.BW.B.....BB..*
......B..W.W...WB...
W.....B...B...B.....
..BE...BBB..BB......
B....B..EWB.B..B....
B.WWB.B.B...BE.W....
B.BB.B...B....BBW.E.
.B.B....B.......WBB.
BB.EBB..B..B..BB....
..BW.W.BE.W......BB.
WBBW.B..B...WEW.....
..W......B......W.EB
B..WBB........B...BB
...E.BB.B.B.B...B..W
.W...BW.EB...B....B.
.W.BB..B.WWB.B.BB...
B...W......B..B....B
W.....W..B.BBW.BBB.B
.BW..B....B..WBB.W..
B.W.WBW...BWHB.WWB.*
