*..B.W.WB..B.......*
...BBB.WB..W.B..W...
B...W....B.....W..B.
B.BEWB....B..B....W.
.B..W..E.........B..
.B..B.....BE..B.W...
....WW.....WBB.E....
B..EBW.B.BB.W..W..B.
...W.B.EBW.BBB.BWBW.
W..W.B.....E.W..W...
B....B...BW....E...B
WWBE........BB..W..B
.....B.E.BWB.WB...W.
.B.BB......E.......B
.....BBWB.B.BB.E....
...E...W.BB..W....WW
..B.BB.E..B...B....B
BBBB..BB...EW...H...
..B.BBBW....B..E....
*......B.W.........*
