*....BWW.W..B......*
.....B....B....B.B..
W.B..BBWWB...W..BWW.
..BEB.B.B.BW.W.B....
B.B.W...EB.....B...B
B..BB....B..BE..B..B
..WBBB....BB.....BEW
..B...BW...W.....BB.
...E.B..WW....W.....
B.B.BBW.E....B......
...BB........EBBWBBB
.BWB.B.WB.B.W.BB.BE.
WB.BB.B.B.B.W...BB.W
...E...BB.BB.B...W.B
WWB.....E..B........
...B..B.B.B..E......
B...B...B.BB..B...EB
..WB.W...W.BBB....WB
B........B...BW.W...
.W.W...W.BHW.BBB...*
