*...W.B...W.B.B....*
....B..B....B..B....
..BB.B..B.W.W.BB....
.BWEBW...W...WW.....
.B.....E.......BB.B.
BB.BB......E..B..B..
.......WB.....BE.B..
WBWE.W..B.BBB.W.W...
..W....E.B...WB.BBW.
.........B.E...W....
B.W.....W.BB...EW.BH
..WEWW......W...W...
W..B.WWEBB..B.......
.B...W..B..E.....BB.
..B....BBBWB..BEBWW.
W.BB.B............B.
.WB.B.....B...B...B.
...B....B.W.W..WBBB.
......BB....B.B.B...
*..B.B.....B.B...W.*
