*...W.B...B....WB..*
....BBW.......B.B...
.BB..B...B..........
B..E..W.B...B....BB.
..WBB..E.....W...BB.
..B.BB.WB.BEW.B....W
....W.....W..W.E...W
...E.B.....B.B......
B.B..B.E..BBBW.....B
W...BWB....EB....W..
.BWB.....W.B..BE..B.
.BWE..B...W....B..B.
.......EWWB..B.B.WB.
.B......BWWEB...BH..
.B.........W..BEW...
..BE...W.WBB.W...B..
W....WW...BW...BB..B
...W...BWB..B.BW...B
...BBBB......B.BB...
*.....B...B...WW...*
