*.W....BWB.........B
.....BBB......W..WB.
B......B..B.......WB
.BBE....W..W.......W
..WW..WWB.E..B.W.WBW
B...W..WB........E..
...BW...W...W...B.WW
..W.B.BW.......B....
......W......W...B..
....BW..W.........B.
BBWE...B..B.B..W....
B.B.B.B.W...WW.B....
..B..W.....W...B.BB.
WBB.BB...BBBH..B..B.
B..W...W.B.W.B...BB.
B.....B...B......BBB
B.....B.W.B.W..W....
..........B.W.B....B
B..WB.W........W....
...B......W...W.WB..
