*..B.B.B.BWB.......*
......B.BB..WBB.....
....B..B.B..B.W.BBB.
W..EW..WB.WE........
B.B.B.EB..WB.BE.....
...B.....E..BWW..E..
W..E..B...BBB...B...
......EBW..B.BWB..B.
.B.B.W...EWB.WWB....
BBBE..WBB...B...WB..
B.B.BBE.B.....B.B.BH
.........E.B...WWW..
...EWBW.B..B.....B.W
...B.BE.......B.WB..
.....B...E...W.B....
W.WE..BBW....B...BW.
....W.EBWBWW.B..BWB.
.BBW.BB..EBW..B...BB
..WE.........BB..W..
*.B.B......BB...B..*
