*..W..B......W.....*
........B.B..BWBB...
..W.B..B.B.W..WW...B
.B.E.B.BB....WW.....
B..BWW.BEBB.BW...WW.
...B.B...B.B.EWW.BW.
..B....BBB....W.B.EB
......B..BB.WBBBW.BB
WB.E.....W....B.BB..
.BW.B..BE....WB.....
B.....B..W.B.E....B.
.W.W..B.W...BW..W.EB
..........WBH..BW.WW
...E.BB.BB.B..BB.B.B
........B.......W...
B...B......B.BB.BBB.
.....WB....BBB..BBB.
.B.B...B.B.B..B.BB..
.WBB.B..WB.BW.......
B..B..W....B..BB.B.*
