*.WBBBW.....B......*
..BB....BB...WBB.B..
.....W..B....B..BB..
WB.E.WBW...E..B.B.W.
......EB....W.E..BB.
.B..BWB..E.B.W.WWEBB
...E..B.WB..EWBB.BBB
.W....E..BWB.WBE....
.B..BB.B.EW..BB..BW.
...E............B...
..BBWBEB...BBB...H..
...B.W.BBE....B.BW.W
...EBWW......BB...BB
...W..EBW..B.B..W..W
...W...B.E..W..B....
W..EB....B........W.
B....BE.B....B.B.BB.
B.W..BWBBE..B..BB...
...E.........WBB.W..
*...B..W.BB..BW....*
