*.B.....B..W.B..BB.*
....W.B......B..BW..
B..BWBBB.BB.B.W.....
...E..BW.....W...B..
..WWB..WE....B..BBBB
..WB...W.W..WE...B.B
BBW..B.BW.....B...E.
.B..W...WBBBBBB...W.
.BBEB.W.BB..B.B.....
B.W.B...E..W...W.BB.
BW....B......EB.BB..
B..B.....BWW....BBEB
..BBBB...........BB.
.B.EBBB......W.B....
.....B.BE..B......B.
...BWB.B...BWEW.....
....BW...BB..BHW....
.B.W...BBBBWBB..W..W
.B.B.B......B.......
W..BBBW....W.BW..B.*
