*.B..B....W.B.WB...W
..............BWB..B
.........W.BB....W..
...EB.B..WB..BW.W.BB
.....BB...EW....B...
WB...W...BB......E..
.B..BB.BW.......WB.B
B......BB.WW..B.BW.W
..B......WW.W.W....B
.W.W.B....W...W.....
...B......B.B.....B.
.B.W....B.BB.WW.....
BB.B.W..B....WWB....
WB...BB..WB.W.......
W...W.W.BW.....B....
..W.......W.BH.BB...
B...........B..BB...
....B.W..W........W.
BW...BW......B.W.WB.
.......B.....W..B.WB
