*......W.W...WWW....
.......BBB.W....B...
...BWB....B..B.B.W..
...E.W.BW...WWB.....
.B.W..W.WBE.B...B...
BW..........B....E..
.....B.B.W..B.BW..B.
..WB....W.......W.B.
W..WB..B..B..W..W...
.W...B....B.B.B.....
.W..W......WB.......
B..B..B....BW.BWB..B
BB.......WB...W.B...
..B..B..W.......B...
W.B........W.H.B....
.WW..W....BB.B...BWB
.WBW...BW.....B...W.
......WBB.B.BBBW....
.....B.W..BWB...BB.W
..BB.........W..B...
