*.BW..B....B..B....*
...B....B........B..
BWB.........W.W..BBW
WBWE..W...BE.B.B..B.
B....WE..B..WBE....B
W....W..BEW....WBE.B
.W.EB.B.B...E.BB.B..
.WB...E....WBB.EBB.W
BW......WE......B.E.
...EB.B.....E.W.B...
B.....EW..B..BBEB...
.......BBE.B.W...BE.
.W.EB..WB..BEB.....B
BB..B.E.W..W.B...W.B
B........EBBB.BB..B.
B..E..B......B....B.
.B.B.BE.W.W........B
BWB..BB.BEWWBWWWBB.H
...E..W.BB...B......
*..W.B..BBBW...WBB.*
