*..B.B.W.....W.BB..B
......W...BBB..B.BB.
.W....B...B...B.....
B.WE...B........B.WW
..........EWWW......
.BB.W......BB..W.E..
..B.......BW..W..WBB
......W.........B...
WBW.B......BB...WBB.
..BW.....B..........
W..E.W.W..W.......B.
....B..B............
B.B.....WW.....B...B
.W..BB.B......WW....
.W.B..B.....W....W.B
.BB...W.WBB.....HB..
BWB.BBWB.WW.B...WB..
W.......W...WW.BW.W.
B...WB..B...W....B.B
...B....B.BW..WBW.B.
