*..B.B....W........*
.....BB..WW....B.B..
BWWB.B......B..BW...
...EBWBW.B.W.B...B.B
.W...W..EBB.....B...
WBB.....BBBBWEBB.B..
..B.....B.......B.E.
..WB...BWBWBB.B.B...
B..E..B.BBB......WB.
...B....EWW....B.BWB
.B.....B..B..E......
BBB....W......B...E.
B...B...B.WBW...B...
.WW....B..B.WBB.BBB.
..W....B.B..B.BHB.BB
.B......BB.BBWW....B
...W.B....B...W.....
.BWBB......B.....W..
BB...B..BBB..W.B.W..
WWBW.BB.WB...WBB...*
