*...B...WB.B..BWBB.*
..B..W.B.B.....B....
B..B......W...B...B.
...E.B....WB..W.....
..WB..E..B.BB...B.B.
.W...W.B.EW......W..
...E.W....WBBB...BB.
BWBW..E...B..B...W.B
B.B...BWWE.BB..WB.BW
.B.E......B.BB...B..
BW...BEB.B..B....WWB
BB..W....E..B.W.B...
BBBEW...B.....H.B...
......E..B...W....BB
..B.B.WBBEB..B.....W
BBWEBB..B.WWW.B...BB
..W.B.E.............
.B.W..B..B...B...WB.
.....W.BB....B.B....
*...B.B....B.W...W.*
