*....W......B.B..W.*
...B....BBBB..W.B...
.WBB.......B..WWW..B
.WWE..B.BBBBBBBB....
BB......EW..BW..W...
.....BBB...BBE..B...
.B...B..B....W..BBE.
..........B.B.B.B.B.
...E...BW......BB.BB
.BB.B.B.E....BBB...B
.BBWBB.W..BB.E..B...
BB.B.W...WW..B.WW.EB
.BWB...B..BB..B.B.B.
.W.EB.B....BBB..W.WB
W..B...BEW.W...W..BB
.B......W....E..BB..
..B.B.W.B..WBBWB...B
.W.W.......B..BW.B..
B......W.......W...H
..B.B....WB...W....*
