*.B.BBBB.BW.B...W..*
....W.BB.W....B.BB..
.BB...BW.B.......W..
...E...BW.....WBB...
...B.W..E..W.BW..WW.
.B....B.B..B.EB.W..B
.BB..W..BWWW..BB.BE.
...WB..WW.....B..BW.
...EB...B....W.B....
..B..BBBEB..B.....B.
W.....BBB.W..E..BB.B
.W.B..B......B....EW
.B...B...BBW...BB...
.BWEB......B...W....
..WB.B.BEBBBB....B..
B.B.....B...WEB.....
B...BB.B.W...H.WWB.B
B..B.WW.......B.....
.B...BB..BBW..B.B...
.W.B.W.B..B.BBBB.B.*
