*...W.W....W...B.W.*
........WB...BWBB...
W...WW.....B...WW...
...EWB.....E....B..B
B...BBEB..B...EB.BB.
.........E.......E.W
WB.EWB......EBB.WBB.
W.BB..EBBB...BWE...B
BW..B.W..E.W........
.B.EB.B.B...B.B.BWB.
B....BEW..WB..B...BB
......B..EWWBW...BW.
...E.......B.BBBB...
BW..BBE....BB..B.B.B
..BBBB...EW.....B.BB
.WBE......W.W.BB..BH
B.B...EBW.....B.BB..
...B..W..EW.B..B....
..BE...B..W..B.B....
*.......BB.WB.W..B.*
