*..W..B.WB.W..B.B..*
....BB.W....BB.WBW..
W..W..B.W....BBBW...
.B.E....W..B..BW.BW.
..WW..E....BB.BBW.WB
.BW..BB..EBB........
..BE.B......W.B..BB.
B.BB..E..B..W......B
.B.B.BW..E.WBBBWB...
.B.EB..B...BBB.WB...
.B.W.WE..BB.BH....B.
..B.B....E....BB..W.
..BE..BB.WW....W...W
......E.B..BW.....B.
..B.....WEB...BB...B
...EBWBW...BBB.B.BW.
..B...E.W...........
..B..BB.............
..B.......W.....B...
*..BW...BW.B..B.BB.*
