*..WBW..BW..B......W
...B.BB......B....W.
......B......W....WB
...E.........B...W..
.B..WB.W..E..WBBW...
...B.......WBBB.....
..WB...BB....W....BW
.B...W.B..BB....B.B.
.....WB......WBWW...
.......B......BWB..B
.WBW.B...B.B.....W.B
BWW.WW....B.W..W....
..B.W.B......B......
WBW.B..W.WW..B.WB...
...BB.....B....W..W.
........W...B.WW....
....B.....B...B.....
.WB......B.WB.B..B..
.......BBBWBB...W...
W.....BB....B.WBWHB.
