*..B..W.B.....B..B.W
......WW.W..BW....B.
B..W.B.....B.B..W...
.BWE.W..B.W....B...B
...WB.WW..E.W...B...
.WBB.....BB......E..
B....WWW..W.W.BW.BB.
.W.....BB.........W.
.WWB....B.B.WB...B..
........W...W.......
.BBE...WW.BH....W...
W...BWB...WW..B....B
........B.W..WB.B...
...........BB.WWBB..
..B...B.B.B..WW..W.B
..........B.BW......
..B......BBW........
...BB..BBWB.B.B....W
..B...........B...B.
..BB.WB......WB...BW
