*....WBB.W.B.......*
..BBW..W.BB.B..BB...
....B......B....WWW.
..WE..W.W..WB..WB...
.B...B..EBB.WB.BB.BW
..BB..B.B....E..BB..
B........WBWW.B...E.
...B....W......B.B..
B..EW.B..B.WB..W.WB.
B..W..BBE...B......W
.BW..W..B....E.B.B.B
.B....B...B..B...BE.
.WB...B..B...B..H.BW
B..BB..BB..B.BWBB.B.
W.B.B..B..WB..B.B.BB
........B...BBB....B
......W.B.BB.B.W...B
.BB.BWW..W.BBB.W..W.
.W.....B..B......B..
B...BW....B.BB.....*
