*.W..B......W...W..*
..W.B...B..WWB.W....
...B..BB...B......B.
...E.B..BB..BW..WW..
BBW..B.E..........B.
.........BBE.......B
B...W.....B.W..E....
...E..B.....BBBBB...
.B....WE.B....B.....
BBB.B.B.B.BE....B.BB
WB.W.WBB.......E..BB
B..EBBBB..W.W.BW....
W.W....E..W.....BB.B
BW.....BB.WE.B..B...
.....WB.B.B...BEW.HB
...EW.B...W.B.......
..W....EW...B...WBWB
..B.........B.BW...W
....B.WB..B..W......
*.....BB...W.B..WB.*
