*...W.........B.B..*
...W...B.BB..B.B.B..
..BBB...B.....B.B.B.
..BE...BB.BE.BB.B.B.
B..B..EBB..BW.EB..B.
W.....B..E..W.BBBE.B
W..E.BBWBB..E...B.B.
B.WB..E...W.B..E.B..
....B.B.BE..B.....E.
B..E........EB..W.B.
W...W.E.BW.BBB.EBB.H
.W..BB..BE..B..B.BE.
...EB..B...WE...BW.B
B.W...EB.BWWW.W.....
W...B..B.E.B.B.B....
WB.E...WW..WW.W.B...
.W...BE..WBB.W..W..W
.....B.WBE..B.B...W.
..BE.WW.WW...B..B...
*....B.W.........B.*
