*..B.W.B.BB...WW.B.*
..........B......B..
B....B....WB....W...
...EWBW..W....B.B.B.
B..B...E..W.......B.
...B.W.W.BBE.B..W...
.....BB.....WB.E....
.BWEBBB.........B.B.
...B...EW.B.BWB...BW
B....W..B..E.B..B.B.
....B....B...W.EBB..
BB.E...BB.W.BWW.B...
B...B..E.BB..W.W....
.W.......BBW..BBHB..
..WB.W...B.....W.B..
W...B...W.....BB...B
.........W.....B....
W.B.B............W..
..B...B...WB.WB.....
*.B..WB.W.B.WBBBBW.*
