*..BB.....BB.BB....*
..W......B..........
BW.B....W.......W..B
B..EB..B.........B.B
.B....BE..W.W....B..
BW.....B..BE..WW....
.B.BWB.....BW.WE....
.BBEB.B..BB.BB.B..BB
...B.B.EB...W.W..B..
.B..WB.W.W.E....B...
...W..B.B...B.WEB...
.W.E...WW.....B.....
BW...WBE.....WW..W..
W.BB...B...BW..B.B..
..B.....W......BB...
..B.....WW...B..W...
BBB...........B.BBB.
..BWB.B.BB.WB.B.W..W
......W......BB.....
*...BW.....WB.B.H..*
