*...BW.W...WB.......
......W..W...WBB....
B.W..BW.B..B..W.....
.W.E..WWW..W..BW.W..
.B...B....E...W....B
WBW.BBW.......BB.E..
B.WWB...W...B.W..B.B
.B.B.....BB.BB.BBW.B
.W.......B........W.
.WW.BBWW....BBB..B..
...EW.B.....W..B.B.W
...BB..BW..W....BB..
B..B................
BW..B.B............W
...B...W......B..W.B
.B....BBW..B......B.
.B........WB.......W
.WBBBW....W.BB.W....
W........W.W.H......
..B...B..B..........
