*.B.B.WB.....B.....*
...B..BB.WB.B..B.B..
BWB.WBBWB...B..B.W..
B.BE........W.W.....
.B..W..E..BW......W.
B.....B..BBE....B.B.
.......B....WW.EWW..
.B.E...B..W.W.......
.WW..B.E...W..WW..BB
.B.........E...W.B..
BB....B.B......EB..B
...EB.WB..WB.....BB.
...B...E........B...
BB....B...B..W...W.B
..B.BW..B...W..BWB..
..BB..BB.WB..BW....B
B.....B...B.....W.BB
....B...WW..W..W.WH.
...BBB.......B.B.W..
*...B....W...B...B.*
