*..BW.W.WB..W.B.....
.......B..BBW....B..
......BB.BW..BWW....
B.BE.BW.WW..W...B.BB
...BB..WEB..B..B..WW
B..W.......B.EBB..W.
W.WW.....W.BB.....E.
..W.WB......BB......
B..E...BBB...W....B.
..BBB...B.W.B.......
.B....W.BB.W.W.BWWBB
...W.....B.WB..W.BB.
.....BB.......W.BBWW
.....B...WW.B..B....
..W........B.B...B.B
W.....W.....BH..BB..
B.WBBB.....B........
BW........B.......W.
...WBB.B..WWB.......
.W..BW..B...W....B.*
