*.B..B..B.W.B..BB..*
.....B.BBW....B.WW..
.B.....WBB....B.....
...EW....B.E..B.B.B.
B.B...E.WB...BE.....
B.....BB.E...BB.BE..
.BBEB....B..E...B..B
BW.B..E.W.BBW....B.W
B..WBBW.WE...B...BB.
..BE.B........BB....
....B.EBW....W...B..
.WWBBWW..E.BBWB...B.
...E..BW.B..HW....W.
B.B..WEWW.WW..BW...B
....W....EB.....BW..
B..EWB....W..B......
.BBBW.E...BB....BWW.
...WB.B.BE......BB..
...EBB.......BBW....
*.....BB..B..BB..B.*
