*..W.............B.*
....B.......BWBB....
BWB..B..B.W.........
.WWEBB..W.B....BB.W.
.W.....E.WW.B..BB...
W........BBE..W.B..W
.BWB..B...BB.B.E...B
...E.........W...B..
W...B.BE.B..B.BW....
BB.BB.WB.BBE..W.....
B.BBB.W.W..HB.BEB.B.
...EB.....W.B.....W.
.B..W..E.WB.W.B.....
W..B.BBW...E...B.B..
.....B......W..E.W.B
.BWE...B.WBBW....W.W
B......E..B....W....
...B...W..B.B..B.B..
....BBB.BW.BB.......
*.B.BB...........W.*
