*.B.BWWWBW......BW.*
........WB...B...W..
........W..B........
.W.E..W.B.B.B.....W.
.BB..B.E.BW...BB...B
B.B.B.....BE.B.B.BW.
..B.W..WBBBW.B.E..BB
.W.EWB.BB.......BB..
....BB.E.B.......BBB
...W.W.....EW.B..BW.
.....WB...B.B..E...W
..BE..B.....B.......
..W....E..W.B..BB...
B.BBB...B..EBB......
WBW....B.W.....EH.B.
WB.BB..W.W..........
....B.B..B...BW.W.B.
.....B..BW.......B..
....B....WWB.WB.B...
*.WB.WB............*
