*.W....BB..BB.WB...*
..B..BBBB.BW.WB..W..
...B...BBBB...B.B..W
...E.B..B..W....B...
.B......E.BW.B.....B
WBB.....BW..BE.B...B
WB.BBB..B.BWW.W.W.E.
B....B.B.....WB....B
W..E....B..BW.WB....
..B...B.E......BB..B
BWB..WBB.....EB....B
.B.B........B....BE.
B.W...W.B..BBB...B..
B.WEW.B..B..B.WB...B
..B......W.BBW.B.B.B
W......B..W..BBBB...
.BBBB.W..W...B.B....
W......BW...H....BB.
BB.......W.BB..B.W..
.W..B.WWB.......W..*
