*....B..B...B..B...*
......B..BW.W..B....
........B.W......WWB
...E.B...B.EB.WB....
.WBB..E..B.BBB.W...W
..BW.....E...B......
B..EB..W.B....W..B.B
BB..B.EWBBB.B....BWW
.B....W.WEBB.....B..
.B.E.BB.BWW...WW...B
.....BE...BB....BW.W
BB..WB.W.EB.B.WB.B..
...E.B...B...BBBWWB.
..B...E.........B.BB
......W..E..BB...BB.
...E.B........BBBW..
....WWEB......WBB...
BBB...BBBEWW.B...H..
..WEW.W.B.....BB....
*.....B.WB...BB.B..*
