*...BWBB.W.W.......B
....B.....BB.W...W..
B.BW....B.B.W.....WW
B.WE....BBB....W.BB.
...B.B..E.....W.W...
.............EW.B...
BB..WB..W.WW....WWE.
B.....W....BB...WB..
...EBWW.BW..BWW.W..B
.B...B..E.W.....W...
.WBB..B.......B..BB.
..W..B.....BB..B..W.
BBWBBB.B.B........W.
.....B..WB.........B
.BB...WBB.....B.....
....BB......W.BWW..B
...WW..B........B.B.
W.BB...B..WBBH.....B
B.WBB....B....BBB...
...WW.B..WBWW......*
