*.WB..B.W...WBB.....
....................
.W.B....B.WB.B.....B
...E.........WW.B...
.....W.WW.E.W.......
.B.B....B.B....B....
.B...W......W...B...
.BB.BBB.B..W....B..B
...WB...............
W.BB...B.W..B....W..
...WWW.B..B.........
.W..BB.BB.........BW
BBWBBWB..B....WW.W..
....B......B.W.BB.WW
W..B...B.B..B.BW.B..
W...B.WBB....H..W.W.
.B...B...B.B..W..B.B
WW.W.WB.......WB....
...B.W.W..........WW
.BB...B...WB..WWB...
