*.B...BB.W..W.......
.....B..B....BB.BW..
W....B..........B.W.
..WEWW........BBWBW.
WB..BB..E.B.........
..BB..B.W...BE...WW.
.....B...BB..WBBB.E.
B.WB..B.B.........W.
B.BEB.WB.....W...BB.
...B..BWEBB......B..
..BB..B.B....EWBB..W
B..BB........W.B.BW.
....B..B..W..W....H.
W.WB...B.WBBB.W.....
.WWB...W.W..WB.W.B..
.W.....WB.....B..WW.
....B.BWB...WW......
.W......B.W.......BW
...BBW..B....B.WB...
BB.....B...B..W.B..*
