*.B..B....BBW..B...*
...B.B.....B...W.W..
.....BB..B.W..W.....
.W.EB..B...B......B.
.B.B.W.BE.WBB.B.B...
..B..B.BB..BBE....W.
B.W..B...BBB.BB...EW
.BB....B.B.B.W.W.B.B
...E.BBB.BBB.WB.WB.W
.....B..E...BW.BBB..
.B.WB..B..B.WE.BBW.B
.BWB..W.W..B..W..BE.
...WBB..B...BBH.B...
W.BE..B............W
BB....B.EB..B..BB...
.B..W.B......E..W.BB
.BB....B.B...WWWW...
.B...B....WB...B...W
..B...W........WBB..
B...W.WB..W.B..B...*
