*...WB..B.B....BWW.*
.....B.W....BBB.B...
W.B.B.BWW...B..B....
BBBE.B..WB.E.B.B....
.BB.W.EW.B..W.E...B.
......B..EWB..BW.B..
WBWEB...B.......WBB.
..B.B.E.........WBBB
...BWBW..E.BW..B.B..
B.BE..W....B...BWB..
......EW...B........
BBB.W...WE.W...B...B
.B.E.....WBW.HBB....
..W...EWB..BBB.....B
B...B..BBEBBBW.B....
...E....B.B...B..B.W
..W.B.E.BBW.B....W..
....BBB.BE.........W
..WE..B..B..W.......
*..B........B.BWBW.*
