*.W......BBWW.B.....
...W.BW..B..........
BWWB...W..........BB
...E.B.....W.B.....B
WW...WB...E...W.B...
...B.......BWW.B.E..
B............B..B...
.....W.B..BB...W..BW
...B....W...W.W...BB
.....B.......W..W...
..B...BB..BWW..W...W
.B.....W...BB.......
.W..WB...B.B..B...WB
...B..B.B..B...WBB.B
.WBB..W....W...B.BH.
WW.WW..BB..W..W.B.B.
B...B..BB.B.........
....B.B.W....BBBB...
WBB....W...........B
B...W.W...WW....W.W.
