*..BBB..B..B..B....B
..B.B............B..
.B......WB....B.W.BB
...E..BWB.W.BWW.WBB.
.....WWBE..W......BB
WBW..WW...BBBEWBBB..
..W.W.WB...B......EB
..W..BB..WB.W..B..BB
..BEB....W.WW...B...
BB.B..W........B.B..
.WB......B..W...W...
WB....B...BBW.BW...B
....W......BW....W..
B.....B...W.B.....W.
...B.W...B.WB.BB...W
......B.WB.B.....B..
...B......W......H..
B......B...B....W.WW
.....B..B..WW.BWB...
.W.B....W.WBB...B..*
