*.W.WWB..B..B....B.*
...B.W...WB.W...B...
B..B.BWWW...........
.W.E...WB.BB..B.....
.B..B.BE.W......BW..
..BB..B...BE.B.B...B
..W...B........E..W.
..BE.B.WW.B.W..B..B.
.....B.E..W.WBWB....
.......WW..E...W..B.
W..............E.B..
..BEB.B......B...B.B
....W..E.........B.W
...BBW..W..EB.B.....
B.B.BW.WBB.....E.B.B
.B..W.BB...W.BWB...B
.W..B.B.B.......W...
..BB.BW.BW...B...BB.
..WBB.B..W.BB.......
*...B..BB...HBB....*
