*...W.W...B.WB..BBWW
...BWW.B......B.W...
W......B.W.B........
...EW.....B..B..W...
...WB..WEB.B..W..B.B
W.B.WB..W..BBEB.B.B.
B....B..B....B.BW.E.
.............BW...B.
.BBE.W.WB..BB.BBW...
..B.....EBW......W..
...B..W.WB.B......B.
B..W.......W........
B..BWB.BBBBB......B.
B....BW.WBW...W.B..H
.B..B.WW...WBW..BB.W
.W...W..WBB..W..BB..
.B....B.W.........B.
B....WWB..B.....BBW.
.....B.....B.W......
WBB.....B.....B..W.*
