*...BBBBB..B..B....*
..BB.B...B.W....B...
..B..WB...B....B..B.
.B.E..W...BW...B....
.W.B....E.BW.BBB....
....W..WB....E.WB.B.
WB..BB.B...BWB.W..E.
.BBW..B......BW.....
WB.EW..B....WBB.WBB.
....B..BEB......W...
BWWB.B.B.B.B.EW.....
........BBB.BB.BBBE.
.B....B....B........
BB.E....BB...B.BB.H.
W.BB....E.....B..W..
.BB.....BW...E..BB.B
.WW...BB.B..B.......
..B..W.B..BBW..B..WB
.WB..WW.........BW..
WWWW.BBBBW.B.B.B.W.*
