*...B........BB.B..*
......W...W.BBB.....
..W...W......W..BBB.
BW.E..WWB...B.B.W.BW
.BW....E......B...WW
....WB..W..E........
BBBW.BBW.......EW...
...EB.B..BB...B.....
.W.B.B.E...B.B.W...B
..........BEBWB.B...
B....W...B....BEB..W
...E.....B....BB.BB.
......BEBWB...BB...B
W.W...W.WB.E.B....HB
B.B...B...W..W.EBBB.
.W.E.BB..W......B..W
.BB.B..E..W..B.B....
.B.WB..B.B.......WB.
......W...B.B....B..
*.WW.........WB.BB.*
