*..B...BB..BB.B....*
....BB........B.BW..
.W.WB..W...WB..W.B.W
B.BEWBWBB.B..BW....B
..W....BE.B.....B...
......B....BWEBW...B
..W...B.W..BB.WB.BEB
B.B.WB.....B.B......
B..EBB....WB.BB.BBB.
B.B.B..WEW.......B..
.B.W.....WB.WEB.BW.W
..........BBB..B.BEH
...B.BBW..W.....W..B
........B...BWW.B.W.
B...BB.BWB.......B..
.B.......WB...BBWB.B
.B..BB.B........B...
W.B..W.WB..BB....BB.
....BB..B....W.B.W..
B...B......BW...BB.*
