*.B.BWB..B...B..W...
..B...W...W....BBW.W
...W.B...BW..BB..BW.
W.WEB.WW...BW....BB.
...W...BE.BW...W.W..
.B..W......B.EW..B.W
.W.......B...B..B.E.
B...W.......B.B..B..
B..E....W....B.BW.W.
B..WBB..EB.B........
W.....W.BB...W.B.BW.
.B..W.B......B..BB..
.BB.........B.....W.
BBWBB...BB.....WBB..
.B.B.........B..B..B
.....BW..BBHB..BW...
..W...WBBWB..WW.B..W
.....BW..B.WW.B.....
BBWW................
BB...B.....B..W..W.*
