*..BBBB..B..B......*
..B..B..BW.WB..B....
.B....BB..B....B.WBB
B.WEB.....BW.......B
W......BE.........BB
BBB.BB.B....BE..B..W
W....B.BBW......W.EB
.....BW...W.BB...W.W
.B.EBW.BWBW.BW.B..B.
.W..BBBBE......B.B..
...WW.BB..BB.EB.BB..
.B...WB...W..BB...E.
.....B.....W.B....BB
.......WWWW.B.W.W...
W.BB..BB...B....BB..
...B......BBWWB.BB..
BB.BB...W...WHB.B.W.
..BWB..BBB....B..B..
.......W.BB.W..W....
...B....B...B......*
