*.B.B..WB.B.B....W.B
.....W.....W..W.WW..
..BBBB..W....B.WB..W
W..E.............B..
.......WE.....B.B.BB
BBW......B...E..B..W
..B.B.B.......WW.BE.
.B..WWW...B...WWWBW.
...E....W.....WB.WB.
...B.WB......BB...W.
.B...BW.....BB..HW..
...BBB.......BB.B...
B...B.BB..WW....W...
.BBW.....BW..B.B...B
.....B..B.W.B..B....
W..BW.B..WB..WBW.BB.
B..W...WB...W.....B.
.B...W....B.B.B..W..
W....W..B...B..BB...
.B..W.BB.B...BW....*
