*.....B.BW..BB....B.
..B...BWBW..W..WW...
..B...B...BBB..B.B.B
.WBE....WW....B...B.
B.B..W..EB.....WB..B
.BBW.BB...W..E..WW.W
B...W.B....B...B..E.
..W......BW.W....W..
...E..BW...BWB...BB.
.B.B..B.E......W....
.W.W.W...B....WB.WWW
B....BB....B...BB.HB
.W.B..W.B.W...WWW...
.W.WWBW....B.B...B.B
..B.WW.BB.BB........
...B.W.B..B.BBB.....
............W.B.BB..
.WB..W..W......B....
.....B....B.....B...
.WW.B.B..B...B.....*
