*.WBBBB.W.W.B..W.BB.
...W..W..B....WB.B..
.B..B..W....B..BW...
W..E.....B.B........
BW......EB..W..BWW..
.............E....B.
.W.....B...W......E.
B..B..BW.B......BBW.
..BE...BB.B.B...W.B.
BB......WWB.B..W..B.
..B....W..W.....B.BB
B.B.BB..BW...H..W.W.
BB.B.WBW.BBWB...WB..
.....B...WB...B...W.
...........B.WB.....
W...W...B.WB....BBBW
W....BB.B.WWB...B..B
.W.BBW......BW.....W
..B..BW.....B.......
.WB.W.W.B....W.B...*
