*..BB..BW..B....BB.*
....BWB..W.......B..
B.B.....B.B..W......
..WEBB..BWW.BB...W.B
..WB..EB..BB.B....W.
.....B.W.E.........W
.B.EW..B.B.W.WWB.B..
.B....EWB.....B...B.
BW..BB...EBB.....B..
...E.....BB.BW.BB.B.
....B.EWBB.WB..BB...
...BW..WBE.W...B.BB.
B..E....B...B.WW....
W....BE.B......B...B
.B....BW.E.WWBW....B
...EB.W.B...B..BBW..
W.B..WEBB.W....W....
B...W..B.E...BHB...B
.....B...W.....BB...
*...B.BB.....W.B.B.*
