*..BB.B.W...W.W..W.W
...B......WB.......B
.BW..BW.....W.W...BW
...E....B.......B.B.
..BB....W.E.BB.B.B..
...BWWBB.B....B.WW.B
W.....B.......B..WB.
..W..W.....W.....W..
....WB...W.WB.BWW.B.
......B..B....B.B...
..BB...B......W...B.
W.BWBB...B....W..BW.
W.WWB.WB.B...W.WBW..
..............BB....
B......WWB....B....B
..B..B...WWB..BBB...
B.........W.H....B..
......W.......W...BW
..B..WBB....B...W..B
B..W...........B....
