*......W..BB.B.B...*
....BB.........W....
W...W..B.........W..
.W.EWBB...B.....BB..
BWWB.B..E..B..W.BB..
.WBW..B....BBE.B..WB
..W.W.WB.B....B.BWE.
B..B.B.B.BW.B......W
...EBB.........W.B.B
..B..B.BEB..BB.W...B
BBBWB.B..B..BE..W...
.....W.W........BWEB
BW.B.WB...B..B..BB..
...E.WBB.......W..BB
B..WW.B...B..B...B..
....B.BW.....W..WB.B
..B..B.BB...W.W.H...
B.B.B.B..BB.B.B.....
B..BB..B..W....W.B..
.W..BB.BB...BBB.B..*
