*.W.W.BW...B..WBWWWB
......W.WB.W.B.WW...
...........B.BB.W..B
..BE.WB.W...B.W.B.B.
.....W.B.BE...WWB..B
.W.....B.B....BB.B.B
W.........B....W....
.WB..B.W.........B.B
...B...BBB..WB......
...BBWWB......B...BW
B.B...BB.B.B..B.....
.W...B........B.....
B....B..B....WB....B
.W.BW..B.B..W...W..W
.....W..W.WW...W.BB.
...B.............W..
W..W.......B........
.....B...BBH.B....BW
.W.....W.W.BB.W...B.
.....WB.W...........
