*.W.WBBB.WB..WW...B.
..B.BB......B.B..B..
.WW..BB.....W...BW.W
...EB......W.B......
......BB..E..W.B....
...B....W...W..W..W.
B..WW...............
W.....B.B.....B...B.
B.....W..B.B..WWWWB.
WW.BB....BB...WB..B.
..B.W...............
WB....B...W.....BBWW
..B..B......H..WW..B
.B.WB.WB.BB.W.....B.
...B.........BWBB...
B........W.B.....W..
..BBWB......W.......
B.B.W..B....BW..W.B.
...B.WWB.B...B..BW..
B......W..W......B..
