*.........BBB...B..*
..WB......B.BBBB.B..
...W.BB..B..W......B
WBBE.........W.B.W..
WW.B..WEB...........
BB.W..W..W.EB.......
..W..W..WB.B...E...B
...E...W..........B.
.....BBE.B.....WW...
..W....BB..E.BBW..B.
...B......B....EB.B.
W.BE...B.B.BBB.....B
..W.B.BEWW.B....B.B.
..BB...B...E.....B.W
..BBBWBB......BE....
.BWEB.BBW.B.......WB
B.W..B.E.W...B.H..W.
.W..B...BWB.....BW..
..B.....W...W.BBB...
*..WBB..........W..*
