*....W..B.BW.......*
..W.B..........W....
BB....BB....B...B...
.BBE.....B..BB......
..B...EB...WB.B.W..W
..B.B....E...WB...B.
...E.WBB...BWWB....B
..B...E...WW.WB.B...
....BB..BEWWB..WWBB.
B..E.....WBB....B..W
......E.....BW......
..W..W...EWB..B....B
B..E..B...BWW...B.B.
B...W.E......B..BWB.
BB.BB.BB.E..W..BBBH.
..BEB.B..BBWBBBW..W.
..B.B.EB.B......W..W
......W.BEB...BB.WB.
..BE..WBBB...BB.W...
*..B....B..WBB.WB..*
