*......WW...........
...B..WBB.B........B
..W...W.W.......W...
WB.EWB....W.B....W..
........WWEW......B.
W.BWB...B........E.W
.B.....B.WB...W..BW.
B..B..BB..BB..WWB..B
..BW...BB...W....BB.
W.B.B..W....W...B.B.
.B..WBB......BWW....
B..B......B..WW..W..
...B.W..B...B.......
....BB.......BB.WB..
....WW.B......BB....
B.B....W...BB......W
.W.....WBB.....B...B
......BBBW.W..W.W.B.
.B...B......W.WB.W..
......WB..W..HBB.B..
