*.B..WWB...BB...B..*
.......B.WW.........
B.W...W..BWB.BB.....
...E.....B.W..W.WBW.
..B.B.BE.BB.......BB
.....WB....E.....B..
..BWW.......BB.EB..W
.B.EB.....W.........
.W.....E....B....WW.
.W...B.....E...B...W
.BB.WB..B.B.BBBEWBW.
.B.E.BB.WBB.B..BB...
...W...E.B....B.....
...BB.B.W.BE..BW....
.B..B...B...BW.E..W.
BBWE.B..WB.WBW......
W.....WW..B....B.B..
...B.....B..B..WBB.W
.......BB..B...B.B.H
*....B..B....BW....*
