*...B..B.B..B.W.....
..B.B.W......BB.....
.BW..W.BB.W.W...W.W.
..BE..B.....BBW.B...
.....BBWE.....BW.BWW
......W.BBB..EWB....
........W........BE.
B...W.B.......B...BB
...EW.BB...BW.....WB
.WB....WE......BBB..
W..WBB...B...H.WBB..
..BB.....B.W..B.....
..W....B.WW.W.BB.W..
.....B.W.BWBB.......
BW.W....BBBW....B..W
.BBBB...B.WB....WB.B
..BW...W...WB..BW...
....W.BW..B.....B..B
B......W.B.B........
WW.W.....B.B.B..W..*
