*.W...B..BB.W.B...W.
....B..W....BB..W...
.....W...W..B......B
.BBEB.WWWB..BB...B..
..B..BB.E.BB....W.B.
...BWB.....WWE.B....
B.B.....B..BBWB..BE.
..B..B.....B...BB...
B.WEB..W.WB...WB....
W......B..W.B.W....W
B.B....B.W.......B..
BW.B..BWB..BBW...B..
BWB..WB...H.........
BW.........W..B....B
B..B.......WBB..B...
..BW............WB..
WW.B..W..WBW....BW..
.W.W..BW..W.WB..B..W
.......BW.W...B.B...
..B.BB.W.........B.*
