*..B..B.B....BB....*
...WB..BBB....BB....
...B....BW..B...B...
W.BEW...B..E...WB...
..B.W.EB.....WE...B.
.......B.E....B..EBB
.B.E...B.W..E.......
W...BWE.W..B...E.B..
..W....BWEB......B.B
...E..B...B.W.BWBBW.
B..W..E...B..W.BB.BW
..B...WB.E.WBBB....B
B.BEBB...B...W..BBB.
.W....E.WBWB.W...B..
.W...B.B.E..B.B.W...
WBBE..BB..H.B.B..WBB
BB....E...B..W..B...
BWB.WB...E...WB..B.W
...E.BB.....BWB..B..
*..BB...BW..WWW....*
