*...B.....W.W...B...
..B...BW..BB.......B
.W.....W.......BBWB.
W.WE...B..B.B...B.B.
......W..BEW........
WWB..B....BBWW..BEB.
...W.W.B.......B..B.
W.W.B...........BB.B
WW.WB.B.W...B.......
B.B..BB.BW......B...
.W.B..WB...B..BB..B.
.....W.B..B...W.B...
.BW.W.....BH.....B..
.BB......WW...B....B
.W....WW.WB.....W...
W...W........B..B...
B....W.B..W.WW.B....
..W................B
...W.W.BB.W.........
WBB.BW....B.WB.BWB..
