*......B..B..W.....*
....W...B...BW.B.W..
BBW.B...W.W.BW..B.B.
...E.W.WB....B..B.B.
.B......E..B....BB.B
.B.WBB....WBBEBB...B
..B..B.W......B.B.EB
......BB.WB..B...B.B
WB.E..BB.BBBB..W...B
..B..WBBE....B.WB...
BB.B.B.....BBE....WW
B...B...W....BW...E.
B.B...........BBW..B
W.BE.W...B.W...HW..B
.....W..E.B.BB...B.B
.W...W.B.....E..WW..
BB.B..W..B....BB.BB.
.B.B..BW..B...BW.BB.
.....WBB...BB..B.W..
B...WW.BB....B...B.*
