*......WBB.B.BBB.B.*
..B..B......B.......
...WB..B.W...BB...B.
BB.EB.B.B...W.W.W...
...WB..BE....BWBBB..
BB..BB.....WBEB.....
....B..W.....B.BB.EB
WB.B...W.BBB..WBW...
...E....BBWB.WW.BBB.
.B....BWE...B.B.B.B.
..W.BW....B..E......
.B..B......WB..W..EW
...BB.BB.BBB....WWWW
B.BEB..B.B.W..H..B.B
.W..W.B.EB....B..WW.
..WBB........B......
.BW..WBBBB.BB.......
....BB..W..B....BB..
..BW...B.B...B.W....
.BW......B..B.B..W.*
