*.W.BB.W.BW.BB.....*
....BBB.....BB.BB...
...B...B.B.BW.......
...E...WWBB.B.......
..W....E...B....B..B
.B.W...B...E.......B
B.........B....E....
..BEW.........B...B.
...B.B.EW...B....BBB
.....BBB...E..WB....
..W.BB......B..E....
...E.....BBWB.......
B...W..EBB.WBW..WW.W
W..WBBB....E..B.B...
WW....B.W.W.HW.E..W.
W..E.B...........B.W
...WB....BBBB.WB...W
BB.B......BB........
..BW.BBWW.B.WBB.W...
*..B...WWB..B.B.BW.*
