*...W.W.B..W........
..BW.BWB..B.B.W.BB..
BBBWBB...B.BW...W...
..WEB.BWW..B...BB...
....BB..EW.B......W.
B.......W....E..B..W
.W.W...BW..WW..B..E.
..BBWB.......B......
B.BE.W.W.BB...BB....
.W.WB.B....BBW.BWB..
BW...B...W......W.B.
.B...B.BB...........
.W...B.BBBW.W....B.W
..B.B.B..BWHW..BW.BW
....B...B.....BBB...
..WB..WW.WB...B.....
.B...W.WB........BB.
...WW..W....B......B
......B....B........
.W.B.....B..WB.....*
