*.....B...B.B..B...*
.....B.W.W..........
BB.WB........W.W..W.
.WBE.BW.BB.B..B..B.W
B..B...E.......W...W
W......BB.WEW.......
W.B.WBB.....WB.E.BBW
.WBE.BWBBBWBB.B.....
...B...E.W...W..BB.B
.B.B....BB.E..WBB..B
........WW..B..E..B.
...E...BB.WBH....B.W
...B..BE.....BBWBWB.
....WBWWW.BE....W.B.
...B.B...B....BE....
B..E.W....BBBB..B...
B.BB...E....W.B.....
W......B...E.B....W.
..B..B.........E....
*.B..B..W....B.....*
