*.BB..B..........B.*
..B..B.BW....B.B.B..
B.W.WB.....W.BB.B.W.
..BE..B..W....B..B..
....B.BE...B..BBB...
.B.B.B.....E.....W..
BW..WB..BBB.B..E...B
...EBB.W....B...BWW.
BB.WB..E.W.WBB..W..W
.W.......B.E.B....B.
...B...W..W.WB.E...B
.B.EB.B......BB.B...
....B.WE......WH....
B.W......W.E..W..BBB
W...W.......WBBE..B.
...E....BB.B.B.B..BB
..W..W.E..B..B.BB.B.
....W.......W...W..W
..W.......W.BW...B..
*....W......W.B....*
