*..B..BBW..W.WB....*
..W.......B.B...W...
...B...BW.BB....B...
.W.E.B....BEWB.W.B..
B.BB..E.....B.E.....
....B..B.EBBW.W..E.B
B.WEWWWB.....B...BB.
....B.E......B..W.BB
B..BW.W.WE.BBB..B...
B.WE.B..W.B.WBW.W.BB
.....BEB.B.BB..W....
BWWBB.B..E.H..BBBWWB
B..EW.....B.W.B.B..W
B...B.E.......B..BB.
W...B.BWBEB..B....B.
..BEB..B........B...
.W....E...B...B.BBW.
..B..W.B.E.BBWW.....
..BE.B...W....B.....
*....B...B.........*
