*.B...WB.....B..BW.*
..B........BB.BBB...
..W.B....W..BW.W.BW.
WB.E.WBBB..WBB...WBW
.WW..BB.E..WB.BWBWWW
...B..W...B.BE.B..B.
..BBB.WB.W.....BB.E.
......BB.........B..
B.BE.BW.B..BBBWW....
....W...E..W..BB...B
BBB.B.B..BBW.E..BB.B
..BB..B.BB..W..B..E.
.........W...B..B.B.
..BE.B......B.BBB...
..BB.B..E.B...W.....
.....WBWW..BBEB..B..
.BB.B..B..W..B.BBWEW
.W..B.........W.B...
BBB......B.H........
..B..WB........B.B.*
