*...W....B....BB...*
..W..WBWBWW....B.B..
BB....W..B..B......B
...EB.B.BB..W...BBB.
..B.WB..E....W..B...
....WB.B...B.EB.WB..
.B......WWBB.B.BBBE.
B.BBBBBB..W....B.W.B
WW.E.......B.WBB.B.W
..WWBW.WEWW...BB....
.....B...B...E.WB.B.
W.........BBH.W...EW
B.B.....BBB...W..W.B
..BEB.WB.W..B....B..
......B.E..WB..B.B..
BBB.BBW...W.BE..B...
.B.WW..B...B.B..BBE.
B.....BW...BBB.B.B..
B........B......B...
BB....B....B....B..*
