*..BB.W.BB.B.....W.W
...W..BW.WB..B..BBBW
...B..B.W...BB..BBW.
...E....B.....BWWB.B
B.....W.EBW........B
.B.W.WW.....BE...W..
.B.WWB......B.....EB
......B.....WB..BB.B
..BE.....B...W......
...WB...E..BW.B.B.W.
WW....BB.BWB.....W..
.B.BB......W.BB.....
.BBW.W.WW.....W.WWB.
...B.W...B..........
BWB.......W.....HB..
........W.BB.W.BB.W.
.....B..B.B....BBB.W
BW.........WB.......
...WWB.....BBW.BWB..
B..B..W...B...BB...*
