*..W.B.B....WB...B..
.....W......B.BBB.W.
B...B........B...W.W
BW.E...B...BW.W.W.B.
B..BW...BBE.W..B.W..
...W.W....W....W.E..
.B......B..WW..W....
....B......BW..WWBB.
BW..B...............
B..B.W..B......BB...
..........BW...B...H
W....B...B.....B..W.
............B...B..B
....W.W.BBBBBBB.....
.....W..B.B.....B.B.
.....WWBW....W.WB...
....BWW...B..W..B.B.
.WB.WW.WW.WWB.WBB.BB
.................BWB
.....WBB.B...B..W...
