*.W.BB.B.........WW.
...B...B.....W..W.B.
...BW.....B.BB...WB.
B..E...BB......B..BW
......BWEBB...B....B
B....B.W.W.WWE......
B...BB.W......W...EB
B.WWBB.......W..W..B
...E..B..B...BB..B.B
...W...WE..........W
.W......BB.B...W.WB.
B.W...B.....B.....W.
BB.W..B.B....W.BBB..
W.BBW.B..W..BW..WH..
.W.B..W..B.WW..B.B..
..B...B...WB.W.WBWB.
.BBW.B...B...B....B.
.W..BW.B...B......B.
B.B.....W..B.W.B.W..
.....B.....B....W..*
