*.B...W..W...BW..B.*
.....B..WB..B.B.W...
..B...B.BB.......BWW
..BEB....W...BB.....
.B..B.BEB.....B.WWB.
.....B...W.E...W...W
BWBBW......W.B.E...W
B.BE...B.....BB.B.BW
...B.B.EW.B.....B.B.
..W.B......E.B..B.B.
B....WB......B.EB.B.
...E.B..WB....W..W.B
..B...WEBW..W..WB.B.
....BB.....EW.W.BWB.
..B.B......B...E.B..
.B.E.....W..BWB..B.W
.W...B.E...WBB...B..
.WWB.....W.B..H.BB..
....W.B...B.........
*...B.....B.....B..*
