*.............W....W
...B..B....B..B.....
...WB.B.W.B....B....
.W.E.W.B.W..BWW...WB
B.W.......E........W
....BW..WWW..W.B.EW.
....WW.B....B......W
B...W..BBBB..B...BBW
WB...W..BB.W.....B.B
..W.......WBW.......
...EW...B....BB.BB..
...B..B.WW..B.....B.
B.W........W......W.
B.B..B....BB....W...
W.BB.B.W....WB.BWW.B
.W....WBB.B..W...W..
......B....W..W.....
......B.B....HB.B.B.
.B.W...BB...B.BB....
..W...B...B.B...W...
