*..W..........BWB..*
...W..WB...B...BB...
B.B...BB..B.W..B..B.
.B.E..W..B.EW.B.B...
...W.WEB.B.W.BE...B.
W...B..W.E.B.BB.BE..
.B.E..W..W..EB..W..B
W.B..BEB..BW...EBB..
...B.B...E.B...B...W
.BBEB...B..W.W.W.B..
......E.BB...W..BB.W
W.BB....WE..W.....W.
B..E.......BWBH.B...
W.B..BE.W.WB...BB.B.
B..B.W.B.E....B...WB
B..E....BBB.BB...B.B
.BB..BEWW...........
B...B.B..E...B...W.B
...E.BBW..B.....W...
*.....BB.B.WB..W.B.*
