*.B...WB..BBBBB....*
.........W....BB....
.W..W..WBB....B..B.B
..WE.B.BW..EBB.B....
B.B..WE....B.......B
B........EBWB..W.BB.
BB.E.....B.B.....BBB
.B....EW..B..B..B...
B.B......EB.B.W....B
B..E.B.W.....W.B.B..
.W.B.BE....B.B....B.
.W...B..BEWWW..BW...
..BEBBWBW...BW..W...
B..W.BE.BB.B..B....W
.WB..BB.WE.B.W..BB.B
...E...W.WWBB......B
.WWBWBEB.......W.BW.
.......B.E.B....B.WB
..BEB......W..HW....
*..BBB.............*
