*..............B...W
..BB....BBB.....B...
..W..B.W...B...W....
.BWEWW...B...BB.W.B.
.BW....BE.W..BW....B
..B......B.W.EBBB...
...WW..BBB.B......E.
.B.BBW.BW.BB.BB..B..
.B.E..W.B.B......B.B
..BW.WBW.W..BB...W..
.B.B......B....W....
.B....B.B.B.W.......
..B..B..BB...W.WW...
W......W..BB.....B.B
B..........B.W..BWBB
....B..W....W.B.....
.W..W.B..WWW...WBH.W
WW.........WBB...B.W
W..B.BB.WWBWW.......
..BW......B..B.....*
