*........B..W......*
.......BB...B.B.B...
...B.WW....BB..W....
...E.W...B.W........
.W.B...EBB.BB.BBBB..
B.B.....B.BEW.....B.
..B..W...BW.B..E.BB.
B..EW..B.B.BB......B
.B.B.B.EW..B......W.
BW.........EB..W.BBW
WW.BB..B.BB...BE.H..
..BEWB..B...B.B.B...
B...B..E...W...B..W.
.BB...BW.B.E....W...
.B.WBW..B....WWEWW..
....W.WB........B..B
.B.....W..W...BB.B..
..W.W.........B.BBB.
....B.W.W.B..W..B...
*.W..B.............*
