*.B......BB.W..BB..*
.....WWBBBW......W..
W..BBB.W.B..W...B...
...E..W...BEWBB.W..W
.BBBB.EBWBW..BE..BBB
..B.W..BWEB....W.EBB
.B.E....B...B..B....
.BB..BEB..B..W......
B..B...WWE..W.B.....
..BE...B.B........BB
WW...BEBWW..B.BB....
...B.B.W.E...BW.BWWW
BBBE...B.....BB..W..
.....BE......W..BBWB
..B.....BEWB.B......
...E..B...B...B.B..W
...BB.E..B...W.W....
BB..B....EHW.B.B..B.
..WE..BB..W.B.......
*.....B....B.......*
