*.......WB...W...B..
...W.W.BW...B.W.....
....B...BB...W....B.
W.WE....B..W..B....B
....W..BW.E...B..B..
WBB..B.BB.......WE..
....W.B.B..........B
....BB.........WB.B.
...BB.W..W........W.
B.......B...BB.B.WW.
...E.....WB.B.....BB
B.B..W.....WB..BBW.W
B.B..B.WBBH....W....
...B.B......W.......
........B..B.......W
WBBW.W..W.WBBB..W...
BB...W.W.B.WBBB...W.
WW.............WW...
...W.W.B..WB......B.
.....W..W...BB..BBB.
