*..W...........W...*
.....B......B..B....
.W.BBBBW...W..B.BB..
..BEW.BB...EW....B..
..B...EBW....WEW.BW.
W..BB..B.E..W.WB.E..
WB.EB.......E.W...B.
.W..W.E....BB.B.W..B
...B.B...E.B.BBBWBBB
..BE.....BW..W......
...W.BEBB.W..HB.BB..
..BW....WE.B..BB..WB
BW.E.W.B..B.B.....B.
..BWBBEBWB.W...B.BW.
.....W..BE....B..W..
B..EWWW.B.........B.
B...BBE...BBB.......
B..B..BB.EB......BB.
...EB...BB.......B..
*..B...BWBB..W..B..*
