*..W.W...BW....WBB.*
....WB...........B..
B..B.W.WWB..B.....B.
..BE.....W.E....B...
B.BBW.E.....B.E.B...
.W..B.W..E.WBB..WEB.
.B.EWB..WBWBE.....BB
.B..WWE..BB...BE...B
BWB.B.B.BE.B.......W
...E.B.W.BW.BBB....B
W...WWE..BB.........
..B..BBBBE...WW.BBWW
..WEW.BW....WB.B..B.
..BB..E.BW.........B
..BBB..W.E........WB
B..E.B..B.B........W
B.W.BBEB.....H..B..B
...B.....E...BW.B...
..BEB..B.B.....B....
*...BB.BB...BB..B..*
