*.B...B........B....
......B...BW.W......
W..B.W..B...B......B
..WE..BW....WW.WW...
BW.W......E....B....
..B..WW.WB....B....W
..B.....BB...B..WB..
.BB..B.......W....BW
W.....W.........B..B
......BB..W.W..W..B.
W...B...W....WB.B.WB
.BW.W..B.BB..BB..B..
B..B.B....W.B...W..B
.B...B.BW....H....B.
B.....BW.WW.WW..B...
..W...BB..WB....B..B
....B.......WB.B....
W.......B..B....W..B
...W....BW.B.BB..W..
........WBW.B.WW..B.
