*..B..B...B.BBW....*
...BB....W......B...
.BW.BB..BB.B..B.BBB.
...E..BBB..W.....B..
WB.....WEB...B.B....
W.BWB...BBB.WE...B.B
..WB..BB...WBB....EB
.......B......B.....
B..E.......B.W.B..BB
WBW....BE......BB...
B.BB..B...W..E...BBB
.WB..B..BB..B....BE.
B.WBB...........H...
.B.E.BB..B.B.BBWW.B.
WW.B.B.WE.B..BB.B...
B.B.WWB.B..WW.B.....
.WB....B.BB.W.B.....
W...BB..W..W........
BWBBW.....WBWW.B.W..
.B...B.WWB....W....*
