*..B....WW.B.B.BB..*
...WB..B.B..........
.B.B....W...........
.W.EB...WBB.....BW..
B..WW.W.E..BBB.B....
.....W..B.B.BEB..W..
B.....BBBB....W..BE.
...B...BB.....BB.WB.
.BWEBB.B.B.W.BBB..BW
B.......E...BB.B.W..
.WBBB.BB..BB.E...H.B
W....W...W.B.BB...EW
.BB.W......BBWB..BB.
..BB....B...WW.B.BB.
...BBB.B.BBW...W..BB
.BB........B.WB.W..B
.......BB......W....
B...B......B..B.BW.B
....B...B.....BWW...
..BW.WW..W...B.B.W.*
